# # # # # # # #
# S . . # . . #
# . # . # . # #
# . . . F . . #
# # . # # . # #
# . . . . . E #
# # # # # # # #